####################
#                  #
# ##  ##     ###   #
#     ##    ##### ##
# #     # ###      #
# # ##     ## ###  #
# # ## ### ## ###  #
# #  # #    # #    #
#                  #
####################